int level_01[23][40] = 
{
	{0	,0	,0	,0	,0	,0	,0	,0	,0	,0	,	0	,0	,0	,0	,0	,0	,0	,0	,0	,0	,	0	,0	,0	,0	,0	,0	,0	,0	,0	,0	,	0	,0	,0	,0	,0	,0	,0	,0	,0	,0	},
	{1	,1	,1	,1	,1	,1	,1	,1	,1	,1	,	1	,1	,1	,1	,1	,1	,1	,1	,1	,1	,	1	,1	,1	,1	,1	,1	,1	,1	,1	,1	,	1	,1	,1	,1	,1	,1	,1	,1	,1	,1	},
	{1	,2	,2	,2	,2	,2	,2	,0	,2	,2	,	3	,2	,4	,0	,2	,2	,2	,2	,2	,4	,	2	,4	,2	,2	,2	,2	,2	,2	,2	,0	,	2	,2	,2	,2	,4	,2	,2	,2	,2	,1	},
	{1	,2	,4	,0	,4	,2	,2	,2	,2	,2	,	2	,0	,2	,2	,2	,2	,2	,2	,2	,2	,	2	,4	,3	,2	,2	,4	,2	,2	,2	,2	,	0	,2	,2	,2	,2	,2	,0	,2	,2	,1	},
	{1	,2	,2	,2	,2	,2	,2	,2	,2	,2	,	2	,0	,2	,2	,4	,2	,2	,2	,2	,2	,	4	,2	,4	,2	,2	,4	,2	,2	,2	,2	,	2	,2	,2	,2	,4	,2	,2	,2	,2	,1	},

	{1	,4	,2	,4	,4	,2	,2	,2	,2	,2	,	2	,2	,2	,2	,4	,2	,2	,2	,2	,2	,	2	,4	,2	,2	,4	,2	,2	,2	,2	,4	,	2	,2	,2	,4	,2	,2	,2	,2	,2	,1	},
	{1	,4	,2	,0	,4	,2	,2	,2	,2	,2	,	2	,2	,2	,2	,0	,4	,2	,2	,4	,2	,	2	,2	,2	,2	,2	,2	,2	,4	,2	,2	,	2	,2	,2	,2	,4	,2	,4	,4	,2	,1	},
	{1	,2	,2	,2	,0	,2	,2	,4	,2	,2	,	2	,2	,2	,2	,2	,2	,4	,2	,2	,2	,	2	,2	,4	,2	,0	,4	,2	,2	,2	,2	,	2	,2	,2	,2	,4	,2	,4	,4	,2	,1	},
	{1	,5	,5	,5	,5	,5	,5	,5	,5	,5	,	5	,5	,5	,5	,5	,5	,5	,5	,5	,5	,	5	,5	,5	,5	,5	,5	,5	,5	,5	,5	,	5	,2	,2	,2	,4	,2	,2	,4	,2	,1	},
	{1	,2	,0	,2	,2	,2	,4	,2	,2	,3	,	2	,0	,2	,2	,4	,2	,4	,2	,2	,2	,	2	,2	,2	,2	,2	,2	,2	,3	,2	,4	,	3	,2	,2	,2	,2	,2	,2	,0	,2	,1	},

	{1	,2	,2	,3	,2	,2	,2	,2	,2	,4	,	2	,2	,2	,2	,2	,0	,2	,2	,2	,2	,	2	,2	,2	,2	,4	,4	,0	,4	,2	,2	,	4	,2	,2	,2	,2	,4	,2	,2	,2	,1	},
	{1	,2	,2	,2	,4	,2	,2	,4	,2	,4	,	2	,2	,2	,2	,2	,2	,2	,2	,2	,2	,	2	,2	,2	,2	,4	,0	,2	,4	,2	,2	,	4	,2	,2	,2	,2	,2	,2	,2	,2	,1	},
	{1	,2	,4	,2	,2	,2	,2	,2	,4	,2	,	2	,2	,2	,2	,2	,2	,2	,4	,4	,4	,	2	,2	,2	,2	,2	,2	,2	,4	,2	,2	,	0	,2	,3	,2	,2	,2	,2	,4	,2	,1	},
	{1	,2	,3	,2	,2	,0	,2	,2	,4	,2	,	0	,0	,2	,2	,2	,2	,2	,4	,2	,4	,	3	,2	,2	,3	,2	,2	,2	,2	,4	,2	,	2	,2	,4	,2	,2	,3	,2	,0	,2	,1	},
	{1	,2	,0	,4	,2	,2	,2	,2	,2	,2	,	2	,2	,2	,2	,2	,2	,2	,2	,4	,0	,	4	,2	,2	,4	,2	,2	,2	,2	,2	,2	,	2	,2	,3	,2	,2	,2	,2	,2	,4	,1	},

	{1	,2	,2	,2	,2	,2	,2	,2	,2	,5	,	5	,5	,5	,5	,5	,5	,5	,5	,5	,5	,	5	,5	,5	,5	,5	,5	,5	,5	,5	,5	,	5	,5	,5	,5	,5	,5	,5	,5	,5	,1	},
	{1	,4	,4	,2	,2	,2	,2	,2	,2	,2	,	2	,2	,4	,2	,2	,2	,3	,2	,2	,2	,	2	,4	,2	,2	,2	,2	,2	,4	,2	,2	,	2	,4	,2	,2	,2	,2	,2	,2	,2	,1	},
	{1	,0	,0	,2	,2	,2	,2	,2	,2	,2	,	2	,2	,0	,4	,2	,2	,4	,2	,2	,2	,	2	,2	,2	,2	,2	,4	,2	,2	,2	,2	,	2	,2	,4	,2	,4	,4	,2	,2	,2	,1	},
	{1	,2	,0	,2	,2	,4	,2	,2	,2	,2	,	2	,2	,2	,2	,4	,2	,2	,2	,2	,2	,	4	,2	,0	,0	,2	,2	,2	,2	,3	,2	,	2	,2	,4	,2	,4	,4	,2	,2	,2	,1	},
	{1	,2	,2	,2	,2	,4	,3	,2	,2	,4	,	2	,2	,2	,2	,2	,2	,2	,2	,4	,2	,	2	,2	,2	,2	,2	,4	,2	,4	,3	,2	,	2	,2	,2	,2	,2	,4	,2	,2	,2	,1	},

	{1	,2	,2	,2	,0	,2	,2	,4	,2	,0	,	2	,2	,4	,2	,4	,4	,2	,2	,2	,2	,	2	,2	,2	,2	,2	,4	,2	,4	,3	,2	,	2	,2	,2	,2	,2	,0	,2	,2	,4	,1	},
	{1	,2	,3	,2	,2	,2	,2	,0	,2	,2	,	2	,2	,2	,0	,2	,2	,2	,2	,2	,2	,	2	,2	,2	,0	,2	,4	,2	,2	,4	,2	,	2	,2	,2	,4	,2	,2	,2	,4	,2	,1	},
	{1	,1	,1	,1	,1	,1	,1	,1	,1	,1	,	1	,1	,1	,1	,1	,1	,1	,1	,1	,1	,	1	,1	,1	,1	,1	,1	,1	,1	,1	,1	,	1	,1	,1	,1	,1	,1	,1	,1	,1	,1	}
};
